[[command_exec_exec]]
[command]*`exec`* führe externe Befehle aus::

----
/exec  -list
       [-sh|-nosh] [-bg|-nobg] [-stdin|-nostdin] [-buffer <name>] [-l|-o|-n] |-sw|-nosw] [-ln|-noln] [-color off|decode|strip] [-rc|-norc] [-timeout <timeout>] [-name <name>] <command>
       -in <id> <text>
       -inclose <id> [<text>]
       -signal <id> <signal>
       -kill <id>
       -killall
       -set <id> <property> <value>
       -del <id>|-all [<id>...]

   -list: zeigt laufende Befehle an
     -sh: die shell wird verwendet um Befehle auszuführen (Standardverhalten)
   -nosh: die shell wird nicht verwendet um Befehle auszuführen (wird benötigt, falls der Befehl mit sensiblen Daten hantiert. Zum Beispiel der Inhalt einer Nachricht eines anderen Users)
     -bg: führt Prozess im Hintergrund aus: gibt weder eine Prozessausgabe noch einen Rückgabewert aus (nicht kompatibel mit Optionen -o/-n)
   -nobg: gibt Prozessausgabe und Rückgabewert aus (Standardverhalten)
  -stdin: erstellt eine PIPE um Daten zu dem Prozess zu senden (mittels /exec -in/-inclose)
-nostdin: es wird keine PIPE für stdin erstellt (Standardverhalten)
 -buffer: zeigt/sendet Ausgabe des Befehls an diesen Buffer (wird der angegebene Buffer nicht gefunden wird ein neuer Bufger mit dem Namen "exec.exec.xxx" erstellt)
      -l: gibt die Ausgabe des Befehls lokal im Buffer aus (Standardverhalten)
      -o: gibt die Ausgabe des Befehls im Buffer aus (nicht kompatibel mit Option -bg)
      -n: gibt die Ausgabe des Befehls in einem neuen Buffer aus (nicht kompatibel mit Option -bg)
     -sw: es wird zum Ausgabebuffer gewechselt (Standardverhalten)
   -nosw: es wird nicht zum Ausgabebuffer gewechselt
    -ln: legt eine Zeilennummerierung an (Standardverhalten, nur für neue Buffer)
   -noln: es wird keine Zeilennummerierung angezeigt
  -color: es wird eine der folgenden Aktionen bei ANSI Zeichenkodierungen in der Ausgabe durchgeführt:
            ansi: ANSI-Kodierung wird beibehalten
          decode: konvertiert ANSI-Farben zu WeeChat/IRC Farben(Standardverhalten)
           strip: ANSI-Farben werden entfernt
     -rc: der Rückgabewert wird ausgegeben (Standardverhalten)
   -norc: der Rückgabewert wird unterdrückt
-timeout: gibt eine Zeitbeschränkung für den auszuführenden Befehl an (in Sekunden)
  -name: dem Befehl wird ein Name zugewiesen (um den Befehl später mittels /exec zu nutzen)
 command: Befehl der ausgeführt werden soll; beginnt der Befehl mit "url:", wird die shell deaktiviert und der Inhalt der URL wird heruntergeladen und im Buffer ausgegeben
      id: identifiziert eindeutig einen Befehl: entweder durch eine Nummer oder einen Namen (sofern ein Name mittels "-name xxx" zugewiesen wurde)
     -in: sendet Text an die Standardeingabe des Prozesses
-inclose: wie -in aber stdin wird danach geschlossen (und der Text ist optional: ohne Text wird stdin umgehend geschlossen
 -signal: schickt ein Signal an den Prozess; das Signal kann entweder ein Integerwert oder eines der folgenden Schlüsselworte sein: hup, int, quit, kill, term, usr1, usr2
   -kill: Alias für "-signal <id> kill"
-killall: beendet alle laufenden Prozesse
    -set: nutzt eine Hook-Fähigkeit (siehe Funktion hook_set in Anleitung für API Erweiterung)
property: Hook-Fähigkeit
   value: neuer Wert für Hook-Fähigkeit
    -del: entfernt einen beendeten Befehl
    -all: entfernt alle beendeten Befehle

Standardoptionen können in der Option exec.command.default_options bestimmt werden.
----

